###########
##  #######
##   $@#  #
## #.#$   #
## #* .#$ #
## #. *  ##
#  .#$# ###
#       ###
####   ####
###########
;Author: David Holland
;Title: diode1

