####
# @###
# *  ####
# *     #
# * ##  #
# * # * #
# * # * #
# * # * #
# .## * #
#     $ #
######  #
     ####
; grigr2001:Dve_dorogi_71
