;source: http://www.game-sokoban.com/index.php?mode=level&lid=11065
       ######
       #    #
######## #.##
# B B@B BB. #
# #.*.#...* #
# B B .BB#. #
#           #
#############