;source: https://www.sokobanonline.com/

########
#.*.  ##
#@#B.  #
# B  B #
#### B##
  #    #
  #   .#
  ######