;source: https://www.soko$anonline.com/

     ####
     #  #
     #  #
     #  #
     #$$#
#####.@*.#####
#   $..* $   #
#   $ *..$   #
#####.* .#####
     #$$#
     #  #
     #  #
     #  #
     ####