;Title: Title: 696-251魔改  (MF8 196th Sokoban Competition, Main simplified-version-5)
;Author: Dries De Clercq+闲+裳不齐+西北天狼
--####------
-##--######-
-#--------##
-#-******--#
-#-*----*--#
-#-*-##$*-##
##-*-##-.-#-
#--*-######-
#--*--#-----
#-$.--#-----
#@-*-##-----
#######-----
