;source: https://www.sokobanonline.com/

  ####
###  #
#  $ ###
#..*$ @#
#   .$ #
# .# ###
##$# #
 #   #
 #####